20 12 2

 3  3  3  3  3  3  3  3  3  3  3  3  3  3  3  3  3  3  3  3
 3  3  3  3  3  3  3  3  3  3  3  3  3  3  3  3  3  3  3  3
 3  3  3  3  3  3  3  3  3  3  3  3  3  3  3  3  3  3  3  3
 3  3  3  3  3  3  3  3  3  3  3  3  3  3  3  3  3  3  3  3
 3  3  3  3  3  3  3  3  3  3  3  3  3  3  3  3  3  3  3  3
 3  3  3  3  3  3  3  3  3  3  3  3  3  3  3  3  3  3  3  3
 3  3  3  3  3  3  3  3  3  3  3  3  3  3  3  3  3  3  3  3
 3  3  3  3  3  3  3  3  3  3  3  3  3  3  3  3  3  3  3  3
 3  3  3  3  3  3  3  3  3  3  3  3  3  3  3  3  3  3  3  3
 3  3  3  3  3  3  3  3  3  3  3  3  3  3  3  3  3  3  3  3
 3  3  3  3  3  3  3  3  3  3  3  3  3  3  3  3  3  3  3  3
 3  3  3  3  3  3  3  3  3  3  3  3  3  3  3  3  3  3  3  3

 5  6  6  6  6  6  6  6  6  6  6  6  6  6  6  6  6  6  6  7
 8  0  0  0  0  0  0  0  0  0  0  0  0  0  0  0  0  0  0  9
 8  0  0  0  0  0  0  2  0  0  0  0  0  0  0  0  0  0  0  9
 8  0  0  0  2  0  0  2  0  0  0  0  0  0  0  0  0  0  0  9
 8  0  0  0  0  0  0  2  0  0  0  0  0  0  0  0  0  0  0  9
 8  2  0  0  0  0  0  0  0  0  0  0  0  0  0  0  0  0  0  9
 8  0  0  0  0  0  0  0  0  0  0  0  0  0  0  0  0  0  0  9
 8  0  0  0  0  0  0  0  0  0  0  0  0  0  0  0  0  0  0  9
 8  0  0  0  0  0  0  0  0  0  0  0  0  0  0  0  0  0  0  9
 8  0  0  0  0  0  0  0  0  0  0  0  0  0  0  0  0  0  0  9
 8  2  0  0  0  0  0  0  0  0  0  0  0  0  0  0  0  0  0  9
 10  11  11  11  11  11  11  11  11  11  11  11  11  11  11  11  11  11  11  12

 1  1  1  1  1  1  1  1  1  1  1  1  1  1  1  1  1  1  1  1
 1  0  0  0  0  0  0  0  0  0  0  0  0  0  0  0  0  0  0  1
 1  0  0  0  0  0  0  1  0  0  0  0  0  0  0  0  0  0  0  1
 1  0  0  0  1  0  0  1  0  0  0  0  0  0  0  0  0  0  0  1
 1  0  0  0  0  0  0  1  0  0  0  0  0  0  0  0  0  0  0  1
 1  1  0  0  0  0  0  0  0  0  0  0  0  0  0  0  0  0  0  1
 1  0  0  0  0  0  0  0  0  0  0  0  0  0  0  0  0  0  0  1
 1  0  0  0  0  0  0  0  0  0  0  0  0  0  0  0  0  0  0  1
 1  0  0  0  0  0  0  0  0  0  0  0  0  0  0  0  0  0  0  1
 1  0  0  0  0  0  0  0  0  0  0  0  0  0  0  0  0  0  0  1
 1  1  0  0  0  0  0  0  0  0  0  0  0  0  0  0  0  0  0  1
 1  1  1  1  1  1  1  1  1  1  1  1  1  1  1  1  1  1  1  1
